0 0 0 0 0 1 1 9 1 1 1 9 1 1 1 9 1 1 1 9 1 0 0 0 0 0
0 0 9 2 2 2 9 2 2 2 9 2 2 2 9 2 2 2 9 2 2 2 9 2 0 0
0 9 3 3 3 9 3 3 3 9 3 3 3 9 3 3 3 9 3 3 3 9 3 3 3 0
9 4 4 4 9 4 4 4 9 4 4 4 9 4 4 4 9 4 4 4 9 4 4 4 9 4
3 3 3 9 3 3 3 9 3 3 3 9 3 3 3 9 3 3 3 9 3 3 3 9 3 3
2 2 9 2 2 2 9 2 2 2 9 2 2 2 9 2 2 2 9 2 2 2 9 2 2 2
1 9 1 1 1 9 1 1 1 9 1 1 1 9 1 1 1 9 1 1 1 9 1 1 1 9
0 2 2 2 9 2 2 2 9 2 2 2 9 2 2 2 9 2 2 2 9 2 2 2 9 0 
0 0 3 9 3 3 3 9 3 3 3 9 3 3 3 9 3 3 3 9 3 3 3 9 0 0
0 0 0 0 0 4 9 4 4 4 9 4 4 4 9 4 4 4 9 4 4 0 0 0 0 0
