5 0 0 5 0 0 5 0 0 5 0 0 5 5 0 0 5 0 0 5 0 0 5 0 0 5
0 0 0 0 0 0 0 0 0 0 0 0 0 0 0 0 0 0 0 0 0 0 0 0 0 0
5 0 6 6 6 6 6 6 6 6 6 6 6 6 6 6 6 6 6 6 6 6 6 6 0 5
0 0 6 8 8 8 8 8 8 8 8 8 8 8 8 8 8 8 8 8 8 8 8 6 0 0
5 0 6 8 3 3 3 3 3 3 3 3 3 3 3 3 3 3 3 3 3 3 8 6 0 5
0 0 6 8 2 2 2 2 2 2 2 2 2 2 2 2 2 2 2 2 2 2 8 6 0 0
5 0 6 8 8 8 8 8 8 8 8 8 8 8 8 8 8 8 8 8 8 8 8 6 0 5
0 0 6 6 6 6 6 6 6 6 6 6 6 6 6 6 6 6 6 6 6 6 6 6 0 0
5 0 0 5 0 0 5 0 0 5 0 0 5 5 0 0 5 0 0 5 0 0 5 0 0 5
0 0 0 0 0 0 0 0 0 0 0 0 0 0 0 0 0 0 0 0 0 0 0 0 0 0
