1 2 3 4 1 0 0 0 0 0 0 0 1 9 0 0 0 0 0 0 0 9 8 7 6 5
8 7 6 5 0 2 0 0 0 0 0 2 0 0 8 0 0 0 0 0 8 0 1 2 3 4
9 1 2 3 0 0 3 0 0 0 3 0 0 0 0 7 0 0 0 7 0 0 5 6 7 8
0 0 0 0 0 0 0 4 0 4 0 0 0 0 0 0 6 0 6 0 0 0 0 0 0 0
0 0 0 0 0 0 0 0 5 0 0 0 0 0 0 0 0 5 0 0 0 0 0 0 0 0
0 0 0 0 0 0 0 6 0 6 0 0 0 0 0 0 4 0 4 0 0 0 0 0 0 0
9 8 7 6 0 0 7 0 0 0 7 0 0 0 0 3 0 0 0 3 0 0 8 7 6 5
1 2 3 4 1 8 0 0 0 0 0 8 0 0 2 0 0 0 0 0 2 0 9 8 7 6
5 6 7 8 9 0 0 0 0 0 0 0 9 1 0 0 0 0 0 0 0 1 2 3 4 5
0 0 0 0 0 0 0 0 0 0 0 0 0 0 0 0 0 0 0 0 0 0 0 0 0 0

